NO ./assets/Wall.xpm
SO ./assets/Wall.xpm
WE ./assets/Wall.xpm
EA ./assets/Wall.xpm

F -255,100,0
C 225,30,0

        1111111111111111111111111
        1000100001100000000000001
        101101W001110010101010001
        1001000000000101010101001
111111111011000001110000000000001
100000000011000001110111111101111
11110111111111011100000010001
11110111111111011101010010001    
11000000110101011100000010001    
10000000000000001100000010001
10000000000000001101010010001
1100000111010101111101111000111  
11110101 1111101 101111010001
11111111 111 111 111111111111