NO ./assets/Wall.xpm
SO ./assets/Wall.xpm
WE ./assets/Wall.xpm
EA ./assets/Wall.xpm

F 255,100,0
C 225,30,0

1111111
100000111
100011001
111110001
    10011111
    1111
    1001
11111111
11 11001
11110001
11111111