NO ./assets/wall_NO.xpm
SO ./assets/wall_SO.xpm
WE ./assets/wall_WE.xpm
EA ./assets/wall_EA.xpm

F 255,100,0
C 225,30,0

        1111111111111111111111111
        1000100001112111000000001 
        1011010001110010101010001 
        1001000S00000101010101001 
111111111111000000000000001111111 
100000000011000001112111111101111 
111101111111112111000000100011
11110111111111011101010010001    
11000000110111011100000010001    
100000000001 1001100000010001
10000000000111001101010010001
1100000111010101111101111000111  
11110101 1111101 101111010001
11111111 111 111 111111111111